
NO ./walls_xpm/bloodWall2.xpm
SO ./walls_xpm/question_flip.xpm
WE ./walls_xpm/helpMe.xpm
EA ./walls_xpm/bloodHands.xpm

F 128,128,128
C 141,11,11

11110
10001
10N01
10001
11111
