NO ./walls_xpm/bloodWall2.xpm
SO ./walls_xpm/question_flip.xpm
WE ./walls_xpm/helpMe.xpm
EA ./walls_xpm/bloodHands.xpm

F 128,128,128
C 141,11,11

        1111111111111111111111111
        1000000000110000000000001
        1011000001110000000000001
        1001000000000000000000001
111111111011000001110000000000001
100000000011111111110111111111111
11110111111        1000010001
111101111          1010010001
1100000011         1000010001
10000000011111111111000000001
10000000000000000000010010001
11000001110101011111011110N0111
11110111 1110101 101111010001
11111111 1111111 111111111111