
NO ./walls_xpm/bloodWall2.xpm
SO ./walls_xpm/question_flip.xpm
WE ./walls_xpm/helpMe.xpm
EA ./walls_xpm/bloodHands.xpm

F 128,128,128
C 141,11,11

111111111111111111111111111111111111
100000000000000000000000000000000011
100000000000000000000000000000000011
100010001111111111110000000000000011
100010000011       10000000000010001
100011011001       10000000000010001
100000000001       10000000000010001
100011110001       10000000000010001
10001  10001       10000000000010001
100011110001111111111000000000001001
100N00000000000000000000000000000001
111111111111111111111111111111111111