NO ./walls_xpm/bloodWall2.xpm
SO ./walls_xpm/question_flip.xpm
WE ./walls_xpm/helpMe.xpm
EA ./walls_xpm/bloodHands.xpm

F 141,11,11
C 0,0,0

111111111
100010101
100010101
10001000111
100010000011
100011111001
100000000001
100011110001
10001  10001
100011110001
100N0001001
111111111111